40 20
0 0
MAP
----------------------------------------
-######################################-
-######################################-
-######################################-
-######################################-
-####..............................####-
-####..............................####-
-####..............................####-
-####..............................####-
-####################..............####-
-####...............#..............####-
-####...............#..............####-
-####..............................####-
-####..............................####-
-####..............................####-
-######################################-
-######################################-
-######################################-
-######################################-
----------------------------------------